NO ./textures/wall.xpm
SO ./textures/wall.xpm
WE ./textures/wall.xpm


EA ./textures/wall.xpm

F 220,100,0
C 225,30,0


111111111111111111111111111111111111111111

1111111111111111111110N1111111111111111111
1111111111111111111111111111111111111111111


