NO ./assets/textures/redbrick.png
SO ./assets/textures/wood.png
WE ./assets/textures/greystone.png
EA ./assets/textures/colorstone.png

F 135,206,235
C 48,46,42


11111111
10101001
10100001
10100101
100N0101
11111111
